1111111111111
1C00100000001
1110100000001
1P1011E0000C1
1111111111111