111111111111111111111111
1111111111111
