1111111111111
1C00100000001
1000100000001
1P0011E0000C1
1111111111111