111111111111111
100000000000001
10000000N000001
111111111111111